0000000000000
0000101010000
0001010101000
0011101011100
0101010101010
0011101011100
0101010101010
0011101011100
0101010101010
0011101011100
0001010101000
0000101010000
0000000000000